x  x  x  x  x  p  p  p  p  x  x  x  x  t1
x  x  x  x  x  p  p  W1 p  p  p  x  x  p
x  x  x  x  p  p  p  p  p  p  p  x  x  p
p  p  p1 p1 p  p  p  p  x  x  p  p  p2 p
p  p  p  x3 x  x  p  x  x  x  p  p  x  x
p  p  p  x  x  x  p  x  x  x  s1 x  x  x
x  p  x  x  x  x  p  p  p  x  x  x  x  x
x  S1 x  x  x  x  p  e  p  x3 x  x  x  x
x  x  x  x  x  x  p  p  p  x  x  x  x  x
-------
W1 closes p1
t1 teleports p2, s1
S1 opens x3
