x  x  W1 p1 p1 p  x  x  x  p  x1 x1 S1 x  x  
x  x  x  x  x  p  x  x  x  p  x  x  x  x  x
x  x  x  x  x  p  p  p  p  p  x  x  x  x  x
S2 x2 x2 p  p  p  p  s  p  p  p  p  x3 x3 S3
x  x  x  x  x  p  p  p  p  p  x  x  x  x  x
x  x  x  x  x  x6 p  x  x  p  x  x  x  x  x
x  x  x  x  x  x6 p  x  x  p  p2 p2 W2 x  x
p  p  p  x  x  p  p  x  x  p  x  x  x  x  x
p  e  p  x4 x4 p  x  x  x  p  x  x  x  x  x
p  p  p  x5 x  x  x  x  x  p  p3 p3 W3 x  x
-----
W2 opens x2
W3 opens x3
W3 closes p2, x1, p1
S2 opens x4
W1 closes p2
S2 closes p3
S3 opens x5
W1 opens x1
S1 opens x6