x x x x x x x x p p p p x x x 
x x x x x x x x p p p p x x x 
p p p x x x x x p x x p p p p 
p s p p p p p p p x x x p e p 
p p p x x x x p p S1 x x p p p 
p p p x x x x p p p x x p p p 
x p p x1 x x x p x x x x x x x 
x x p p p p p p x x x x x x x 
------
S1 toggles x1