x x x x x x x x x x x x x x x x x x x x x x x x x x
x p p p p p p p p p p p p p p p p p p p p p p p p x
x p s p p p p p p p p p p p p p p p p p p p p p p x
x p p p p p p p p p p p p p p p p p p p p p p p p x
x p p p p p p p p p p p p p p p p p p p p p p p p x
x p p p p p p p p p p p p p p p p p p p p p p p p x
x p p p p p p p p p p p p p p p p p p p p p p p p x
x p p p p p p p p p p p p p p p p p p p p p p p p x
x p p p p p p p p p p p p p p p p p p p p p p e p x
x x x x x x x x x x x x x x x x x x x x x x x x x x
