x  p  p  p1 p1 p  p  x  x  x  x  x  x  x  x
x  p  p  x  x  p  p  p  x  x  x  x  x  x  x
w  w  s  x  x  p  p  p  p  x  x  x  x  x  x
w  w  x  x  x  x  x  p  p  p  x  x  x  x  x
w  w  x  x  x  x  x  x  p  p  p  x  x  x  x
w  p  p  p  x  x  x  x  x  p  p  t1 x  x  x
x  p  e  p  x  x  x  x  x  x  p  p  p  p  p2
x  p  p  p  p  p  p  x  x  x  p  W1 p  p  p
x  x  p  x  x  p  p  x  x  x  p  p  p  x  x  
x  x  p  x  x  p  p  p  p1 p1 p  p  p3 x  x
------
W1 closes p1 
t1 teleports p2, p3
