x  x  p  p  x  x  x  x  x  x  x  x  x  x  
x  x  p  p  x  x  x  x  x  x  x  x  x  x
x  x  p  p  p  x  x  x  x  x  x  x  x  x
x  x  p  p  W1 x  x  x  x  x  p  p  p  x4
x  x  x  p  p  p  p  x3 x  x  p  e  p  x4  
x  x  x  x  x  x  p  p  x2 x2 p  p  p  x
x  p  p  x  x  x  p  p  x  x  x  x  x  x
p  p  S1 p  p1 p1 p  p  x  x  x  x  x  x
p  s  p2 x  x  x  p  p  x  x  x  p  p  p
p  p  p2 x  x  x  p  p  W2 p  p  p  p  p
x  x  x  x  x  x  x  x  x  x  x  p  p  p
--------
W1 toggles x2, x4
W2 closes p1
W2 opens x3
S1 opens x2
