x x x x x p p p p p p x x x x 
x x x x x p x x p p p x x x x 
x x x x x p x x p p p p p x x 
s p p p p p x x x x x p p p p 
x x x x p p p x x x x p p e p 
x x x x p p p x x x x x p p p 
x x x x x x p x x p p x x x x 
x x x x x x p p p p p x x x x 
x x x x x x p p p p p x x x x 
x x x x x x x p p p x x x x x 