x  x  x  x  x  x  x  W1 x  x  x  x  x  x  x
p  p  W6 p  x  x  x  p  x  x  x  x  x  x  x
p  p  p  p  p  x  x  p  x  x  x  x  x  x  x
p  W2 s  p  p  p  p  p  x1 x1 p  p  x3 x3 p
p  p  p  p  p  x5 x  x  p  x  x  x  p  x  x
p  p  W3 p  x  x  x  x  p  x  x  x  p  x  x
p  x  x  x  x  x  x  x  W4 x  x  p  p  p  x
p  x  x  x  x  x  x  x  x  x  p  p  e  p  x
p  x6 x6 S5 x  x  x  x  x  x  p  p  p  p  x
-------
W6 closes x6, x3
W3 closes x6, x3
W1 opens x1
W2 closes x1
W4 opens x6, x3
S5 toggles x5

  